30
16
                            H |
                            H |
              O$$$M      TTTH |
   SRT                      H |
   GDG                      H |
   TRS          ?         C H |
   N                        H |
  $$$                       H |
      A   A? WTTTTT$W $$$$$$H |
                            H |
   PQ   Q   V   V   V    V  H |
GG GGGGGGGGGGGGGGGGGGGGGGGGGH |
DD DDJ   JDDA    DDJ   JDDDDH |
DD                       $W$H |
DD            Q      K      H |
SSSSSSSSSSSSSSSRRRRRRSSSSSSSSS|