368
16
                                                                                                                                                                                                                                                                                                                                                                                |
                                                                               T                                                                                                                                                                                                                                                                                                |
                ?                                                      bbbbbbbbbbbbbbbbbb                                                                         $                                                                                                                                                                                                             |
                             C            T                            b  $$$  T  $$$   b                          C                                                                                                 C                                                                                   C                                                                      | 
                                                             c         b       T        b                                                                                                                                                                                                                                                                C                      |
         ll          2ll                         T                     b       T        b            C                                                     X                                                                                                   C                                                                                                                |
        TTTT         TTTT                T                             b       T      2 b                                                   E       X                C                                                                SSSSSSSSSSSSSSSSSSSSSSSSSS                                                                                                                |
            $$$$$$$$$                                      RRRRRRRRRRRRRRRRHRRRRRRRHRRRRRRRRRRRRRRRR                        jhi             X                                         $           RRRRRRRRR                         SSSSSSSS              SSSSSSS                                                                                   C                           |
                                                                   J       H   J   H       J                               jhhhi                                                                 RRRRRRRRRRR                      SSSS N                       SSSS                                                                                                             |
                       V      V    E                                       H       H                                       ggggg                              TTTT TTTT                           J   J   J                     SSSSSSk     l l  l l  l  l    kSSSSSS                                                                                                           |
                    FGGGGGGGGGGGGGGGk              GGG         k       q   H       H   q       k                           gggZg                             TTTTT TTTTT                                                             SSSSSSSSSSSSSHSSSSSSSSSSSSS                                                                                                                |
  P            V    GDDDDDDDDDDDDDDSS            kSSDS     RRRRRRRRRRRRRRRRRRRRRRRRRRRRRRRRRRRRRRRRR                       ggggg      E                     TTTTTTETTTTTT                      F               kF       kF  k        SSSSSSSSSSSSSHSSSSSSSSSSSSS                                                                                                                |
GGGGGGGGGGGGGGGGGGGGDDDDDDDDDDDDDSSDSSkk         SSDDD     J $ J $ J $ J $ J   J   J   J   J   J   J     SSSSSSSSSSSSSSSSSSSS$DSGGGGGGXGGGGGGGGGGGGGGGGGGGGGGGGGGGGGGGGGGG          E       RRRRRRRRRRRRRRRRSRSSSSLLLLLLSSSSSSSS      J        J  H  J        J     S                                                                                                           |
DDDDDDDDDDDDDDDDDDDDDDDDDDDDDDDDDSDDDSSSLLLLLLLLLSSSDSD                                                SSSSSSSSSSSSSSSSSSSSSS$SDDDDDDDDDDDDDDDDDDDDDDDDDDDDDDDDDDDDDDDDDDDGGGGGGGGGGXGGGGGGGRRRRRRRRRRRRRRRSRSSSSSSSSSSSSSSSSSSSS                 H                SS                                                                                                           |
DDDDDDDDDDDDDDDDDDDDDDDDDDDDDDDDDDSDSSSLLLLLLLLLLLSSSSS                                               SSSSSSSSSSSSSSSSSSSSSSS$DDDDDDDDDDDDDDDDDDDDDDDDDDDDDDDDDDDDDDDDDDDDDDDDDDDDDDDDDDDDDRRRRRRRRRRRRRRRRRSSSSSSSSSSSSSSSSSSSSSS                H               SSS                                                                                                           |
SSSSSSSSSSSSSSSSSSSSSSSSSSSSSSTSSSSSSSSSSSSSSSSSSSSSSSSSSSSSSTSSSSSSSSSSSSSSSSSSSSSSSSSSSSSSSSSSSSSSSSSSSSSSSSSSSSSSSSSSSSTSSSSSSSSSSSSSSSSSSSSSSSSSSSSSSTSSSSSSSSSSSSSSSSSSSSSSSSSSSSSSSSSSSSSSSSSSSSSSSSSSSSSSSSSSSSTSSSSSSSSSSSSSSSSSSSSSSSSSSSSSSTSSSSSSSSSSSSSSSSSSSSSSSSSSSSSSSSSSSSSSSSSSSSSSSSSSSSSSSSSSSSTSSSSSSSSSSSSSSSSSSSSSSSSSSSSSSTSSSSSSSSSSSSSSSSSSSSSSSSSSSSSS|